1111111111111111111111111
1111111111111111111111111
1111111111111111111111111
2222222222233333322222222
2222222222322222222222222
2222222222321222222222222
2222222222222222222222222
3333333331111333333333333
3333333331111333333333333
3333333331111333333333333
3333333331111333333333333
0000000011111110000000000
0000000011111110000000000
0000000011111110000000000
0000000011111110000000000
0000000011111110000000000
0000000011111110000000000
0000000011111110000000000
0000000011111110000000000
0000000011111110000000000